Player,Pos,Age,Tm,G,GS,MP,FG,FGA,FG%,3P,3PA,3P%,2P,2PA,2P%,eFG%,FT,FTA,FT%,ORB,DRB,TRB,AST,STL,BLK,TOV,PF,PTS
Aaron Gordon,PF,25,ORL,19,19,552,91,213,0.427,31,84,0.369,60,129,0.465,0.5,49,80,0.613,33,104,137,80,14,16,53,38,262
Aaron Holiday,PG,24,IND,35,6,667,95,256,0.371,38,108,0.352,57,148,0.385,0.445,29,40,0.725,7,39,46,63,20,4,29,62,257
Aaron Nesmith,SF,21,BOS,18,0,281,25,63,0.397,17,48,0.354,8,15,0.533,0.532,8,12,0.667,10,34,44,7,3,5,11,37,75
Abdel Nader,SF,27,PHO,19,0,273,44,90,0.489,13,33,0.394,31,57,0.544,0.561,20,25,0.8,3,43,46,15,6,7,13,24,121
Adam Mokoka,SG,22,CHI,7,0,42,5,14,0.357,1,8,0.125,4,6,0.667,0.393,0,0,,1,3,4,4,2,1,2,5,11
Al Horford,C,34,OKC,24,24,677,138,312,0.442,47,132,0.356,91,180,0.506,0.518,14,18,0.778,23,137,160,84,21,21,27,43,337
Alec Burks,SG,29,NYK,25,3,617,92,227,0.405,47,117,0.402,45,110,0.409,0.509,47,56,0.839,12,96,108,51,18,5,27,48,278
Aleksej Pokusevski,PF,19,OKC,17,0,296,23,93,0.247,10,56,0.179,13,37,0.351,0.301,0,0,,5,55,60,21,8,19,22,16,56
Alex Caruso,PG,26,LAL,29,0,577,62,145,0.428,28,70,0.4,34,75,0.453,0.524,16,23,0.696,17,63,80,70,30,6,32,51,168
Alex Len,C,27,TOT,26,6,352,54,86,0.628,6,20,0.3,48,66,0.727,0.663,24,42,0.571,19,62,81,23,9,32,25,47,138
Alex Len,C,27,TOR,7,2,76,5,10,0.5,3,6,0.5,2,4,0.5,0.65,3,6,0.5,0,11,11,3,1,6,8,10,16
Alex Len,C,27,WAS,19,4,276,49,76,0.645,3,14,0.214,46,62,0.742,0.664,21,36,0.583,19,51,70,20,8,26,17,37,122
Al-Farouq Aminu,PF,30,ORL,9,6,163,17,43,0.395,6,15,0.4,11,28,0.393,0.465,7,9,0.778,9,28,37,15,8,5,10,9,47
Alfonzo McKinnie,SF,28,LAL,18,0,84,16,30,0.533,5,12,0.417,11,18,0.611,0.617,5,8,0.625,7,13,20,1,2,0,1,7,42
Amir Coffey,SG,23,LAC,20,0,154,21,40,0.525,11,21,0.524,10,19,0.526,0.663,3,9,0.333,3,12,15,8,4,0,8,11,56
Andre Drummond,C,27,CLE,25,25,722,180,380,0.474,0,8,0,180,372,0.484,0.474,77,129,0.597,101,236,337,64,40,29,81,69,437
Andre Iguodala,SF,37,MIA,34,2,735,57,147,0.388,38,112,0.339,19,35,0.543,0.517,14,25,0.56,20,107,127,77,36,16,36,51,166
Andre Roberson,SG,29,BRK,5,0,63,2,14,0.143,1,8,0.125,1,6,0.167,0.179,1,2,0.5,7,8,15,4,3,1,2,4,6
Andrew Wiggins,PF,25,GSW,37,37,1193,241,521,0.463,65,185,0.351,176,336,0.524,0.525,82,122,0.672,38,127,165,81,30,40,69,85,629
Anfernee Simons,SG,21,POR,32,0,543,87,220,0.395,65,158,0.411,22,62,0.355,0.543,22,26,0.846,6,72,78,41,6,5,27,55,261
Anthony Davis,PF,27,LAL,23,23,755,204,383,0.533,17,58,0.293,187,325,0.575,0.555,93,130,0.715,47,146,193,70,31,41,45,42,518
Anthony Edwards,SG,19,MIN,36,19,1048,199,537,0.371,68,225,0.302,131,312,0.42,0.434,70,87,0.805,26,118,144,90,31,15,66,55,536
Anthony Gill,PF,28,WAS,12,1,67,3,10,0.3,1,7,0.143,2,3,0.667,0.35,3,4,0.75,3,16,19,4,3,2,3,3,10
Anžejs Pase??iks,C,25,WAS,1,0,6,0,1,0,0,1,0,0,0,,0,0,0,,1,0,1,1,0,0,5,2,0
Aron Baynes,C,34,TOR,33,26,649,88,200,0.44,17,70,0.243,71,130,0.546,0.483,15,20,0.75,54,125,179,35,10,11,30,80,208
Ashton Hagans,PG,21,MIN,2,0,4,0,0,,0,0,,0,0,,,0,0,,0,0,0,0,0,0,1,0,0
Austin Rivers,SG,28,NYK,21,2,442,58,135,0.43,28,77,0.364,30,58,0.517,0.533,10,14,0.714,5,42,47,42,12,0,22,32,154
Avery Bradley,SG,30,MIA,10,1,211,31,66,0.47,16,38,0.421,15,28,0.536,0.591,7,9,0.778,2,16,18,14,7,1,9,26,85
Bam Adebayo,C,23,MIA,33,33,1119,236,419,0.563,2,6,0.333,234,413,0.567,0.566,160,189,0.847,72,241,313,179,29,34,98,80,634
Ben McLemore,SG,27,HOU,24,2,372,50,140,0.357,32,102,0.314,18,38,0.474,0.471,17,23,0.739,10,41,51,23,14,1,23,34,149
Ben Simmons,PG,24,PHI,31,31,1051,192,332,0.578,2,7,0.286,190,325,0.585,0.581,112,167,0.671,54,191,245,236,49,22,104,96,498
Bismack Biyombo,C,28,CHO,33,19,736,78,137,0.569,0,1,0,78,136,0.574,0.569,29,60,0.483,71,113,184,48,9,38,30,81,185
Blake Griffin,PF,31,DET,20,20,626,81,222,0.365,39,124,0.315,42,98,0.429,0.453,44,62,0.71,7,97,104,77,14,2,32,42,245
Boban Marjanovi,C,32,DAL,18,1,141,36,72,0.5,0,4,0,36,68,0.529,0.5,10,14,0.714,27,44,71,3,1,1,8,16,82
Bobby Portis,C,25,MIL,36,2,776,166,304,0.546,38,76,0.5,128,228,0.561,0.609,23,33,0.697,67,188,255,37,30,15,28,70,393
Bogdan Bogdanovi,SG,28,ATL,11,2,249,35,91,0.385,23,67,0.343,12,24,0.5,0.511,10,11,0.909,2,36,38,24,4,2,13,21,103
Bojan Bogdanovi,SF,31,UTA,36,36,1102,188,435,0.432,98,242,0.405,90,193,0.466,0.545,92,108,0.852,18,122,140,70,18,2,51,59,566
Bol Bol,PF,21,DEN,15,2,84,11,22,0.5,5,10,0.5,6,12,0.5,0.614,1,2,0.5,0,11,11,4,2,5,8,9,28
Brad Wanamaker,PG,31,GSW,37,0,599,58,162,0.358,13,56,0.232,45,106,0.425,0.398,49,55,0.891,8,54,62,99,26,6,35,51,178
Bradley Beal,SG,27,WAS,32,32,1143,368,764,0.482,74,221,0.335,294,543,0.541,0.53,243,269,0.903,43,131,174,151,44,14,105,82,1053
Brandon Clarke,PF,24,MEM,27,16,726,140,272,0.515,15,46,0.326,125,226,0.553,0.542,35,53,0.66,44,111,155,43,33,17,16,43,330
Brandon Goodwin,PG,25,ATL,24,0,289,35,106,0.33,15,53,0.283,20,53,0.377,0.401,17,24,0.708,3,24,27,43,10,0,13,23,102
Brandon Ingram,SF,23,NOP,36,36,1255,306,648,0.472,85,224,0.379,221,424,0.521,0.538,164,185,0.886,22,163,185,172,25,28,84,71,861
Brian Bowen,SF,22,IND,1,0,5,1,2,0.5,0,0,,1,2,0.5,0.5,1,1,1,0,1,1,0,0,0,0,0,3
Brodric Thomas,SG,24,HOU,4,0,24,2,7,0.286,1,6,0.167,1,1,1,0.357,5,7,0.714,1,3,4,4,1,1,4,5,10
Brook Lopez,C,32,MIL,36,36,975,141,302,0.467,55,158,0.348,86,144,0.597,0.558,50,61,0.82,49,134,183,22,19,48,32,76,387
Bruce Brown,PG,24,BRK,33,20,698,118,200,0.59,9,33,0.273,109,167,0.653,0.613,38,53,0.717,51,103,154,46,26,10,26,69,283
Bruno Caboclo,PF,25,HOU,6,0,36,8,17,0.471,0,5,0,8,12,0.667,0.471,1,2,0.5,3,11,14,1,0,2,4,6,17
Bruno Fernando,C,22,ATL,18,0,151,11,25,0.44,0,2,0,11,23,0.478,0.44,9,15,0.6,13,47,60,9,2,2,15,17,31
Bryn Forbes,SG,27,MIL,36,6,675,121,259,0.467,73,163,0.448,48,96,0.5,0.608,20,27,0.741,7,40,47,21,8,0,19,39,335
Buddy Hield,SG,28,SAC,36,36,1253,198,507,0.391,140,370,0.378,58,137,0.423,0.529,54,64,0.844,12,150,162,114,29,11,64,96,590
Caleb Martin,SF,25,CHO,26,1,395,55,133,0.414,19,57,0.333,36,76,0.474,0.485,14,26,0.538,20,53,73,30,21,7,17,26,143
Cam Reddish,SF,21,ATL,26,21,750,96,263,0.365,33,126,0.262,63,137,0.46,0.428,67,82,0.817,22,82,104,35,33,9,34,68,292
Cameron Johnson,PF,24,PHO,34,9,823,125,286,0.437,73,193,0.378,52,93,0.559,0.565,32,37,0.865,19,96,115,46,22,10,26,48,355
Cameron Payne,PG,26,PHO,24,0,394,61,127,0.48,24,57,0.421,37,70,0.529,0.575,13,14,0.929,3,41,44,86,15,5,25,42,159
Caris LeVert,SG,26,BRK,12,4,334,87,200,0.435,22,63,0.349,65,137,0.474,0.49,26,34,0.765,10,42,52,72,13,6,26,20,222
Carmelo Anthony,PF,36,POR,34,3,870,166,402,0.413,60,155,0.387,106,247,0.429,0.488,80,95,0.842,19,94,113,50,31,27,35,72,472
Carsen Edwards,SG,22,BOS,14,1,147,29,63,0.46,11,34,0.324,18,29,0.621,0.548,7,9,0.778,2,12,14,6,4,1,2,16,76
Cassius Stanley,SG,21,IND,8,0,23,2,7,0.286,1,2,0.5,1,5,0.2,0.357,4,5,0.8,2,1,3,0,0,2,1,7,9
Cassius Winston,PG,22,WAS,6,0,44,4,10,0.4,3,7,0.429,1,3,0.333,0.55,2,2,1,0,4,4,6,0,1,1,4,13
Cedi Osman,SF,25,CLE,35,15,904,136,365,0.373,70,211,0.332,66,154,0.429,0.468,39,49,0.796,24,104,128,93,30,4,37,71,381
Chandler Hutchison,SF,24,CHI,7,0,64,5,18,0.278,1,3,0.333,4,15,0.267,0.306,2,2,1,1,19,20,4,1,0,5,9,13
Chasson Randle,PG,27,ORL,8,0,151,15,35,0.429,7,23,0.304,8,12,0.667,0.529,5,7,0.714,1,14,15,23,2,1,6,18,42
Chimezie Metu,C,23,SAC,11,0,71,15,30,0.5,1,3,0.333,14,27,0.519,0.517,6,9,0.667,11,12,23,5,3,6,6,10,37
Chris Boucher,C,28,TOR,36,2,851,172,322,0.534,61,137,0.445,111,185,0.6,0.629,85,112,0.759,67,167,234,36,20,69,26,98,490
Chris Chiozza,PG,25,BRK,15,0,136,17,47,0.362,9,23,0.391,8,24,0.333,0.457,10,13,0.769,3,13,16,36,4,4,10,11,53
Chris Paul,PG,35,PHO,34,34,1080,204,420,0.486,52,133,0.391,152,287,0.53,0.548,83,87,0.954,16,144,160,300,40,10,81,84,543
Chris Silva,PF,24,MIA,6,0,53,6,9,0.667,1,1,1,5,8,0.625,0.722,10,12,0.833,7,11,18,6,1,2,8,14,23
Christian Wood,C,25,HOU,17,17,530,149,267,0.558,32,76,0.421,117,191,0.613,0.618,44,64,0.688,31,143,174,22,16,26,31,32,374
Chuma Okeke,PF,22,ORL,20,0,437,33,86,0.384,17,44,0.386,16,42,0.381,0.483,5,10,0.5,18,52,70,39,16,7,13,19,88
CJ Elleby,SF,20,POR,13,0,105,14,31,0.452,5,19,0.263,9,12,0.75,0.532,6,9,0.667,4,10,14,3,4,3,3,18,39
CJ McCollum,SG,29,POR,13,13,440,123,260,0.473,63,143,0.441,60,117,0.513,0.594,38,45,0.844,7,44,51,65,17,4,13,28,347
Clint Capela,C,26,ATL,32,32,949,208,353,0.589,0,0,,208,353,0.589,0.589,55,100,0.55,159,294,453,29,24,71,46,73,471
Coby White,PG,20,CHI,34,34,1130,201,479,0.42,81,229,0.354,120,250,0.48,0.504,69,77,0.896,17,155,172,171,12,5,80,86,552
Cody Martin,SF,25,CHO,23,2,268,33,64,0.516,4,20,0.2,29,44,0.659,0.547,8,10,0.8,19,35,54,24,12,4,15,13,78
Cody Zeller,C,28,CHO,18,15,421,73,142,0.514,3,19,0.158,70,123,0.569,0.525,25,33,0.758,46,90,136,44,11,11,20,47,174
Cole Anthony,PG,20,ORL,25,17,667,101,269,0.375,27,83,0.325,74,186,0.398,0.426,46,55,0.836,20,91,111,94,17,11,51,51,275
Collin Sexton,SG,22,CLE,31,31,1127,274,563,0.487,52,130,0.4,222,433,0.513,0.533,147,183,0.803,21,60,81,138,36,4,91,88,747
Cory Joseph,PG,29,SAC,36,2,749,90,201,0.448,24,75,0.32,66,126,0.524,0.507,27,35,0.771,20,58,78,85,24,7,36,83,231
Cristiano Felício,C,28,CHI,6,0,38,3,4,0.75,0,0,,3,4,0.75,0.75,5,8,0.625,6,6,12,5,2,0,3,3,11
D.J. Augustin,PG,33,MIL,34,6,664,64,183,0.35,45,123,0.366,19,60,0.317,0.473,35,39,0.897,11,35,46,103,19,1,30,27,208
D.J. Wilson,PF,24,MIL,11,0,99,15,41,0.366,9,26,0.346,6,15,0.4,0.476,1,2,0.5,3,20,23,3,1,4,4,12,40
D?vis Bert?ns,PF,28,WAS,30,3,783,100,258,0.388,88,229,0.384,12,29,0.414,0.558,58,68,0.853,14,80,94,28,19,7,18,75,346
Dakota Mathias,SG,25,PHI,8,2,123,19,48,0.396,8,26,0.308,11,22,0.5,0.479,2,6,0.333,1,6,7,13,1,3,1,7,48
Damian Jones,C,25,TOT,17,1,125,13,21,0.619,0,1,0,13,20,0.65,0.619,8,13,0.615,9,14,23,4,1,9,6,25,34
Damian Jones,C,25,PHO,14,0,94,8,16,0.5,0,1,0,8,15,0.533,0.5,6,11,0.545,7,11,18,4,1,5,6,19,22
Damian Jones,C,25,LAL,3,1,31,5,5,1,0,0,,5,5,1,1,2,2,1,2,3,5,0,0,4,0,6,12
Damian Lillard,PG,30,POR,34,34,1224,315,708,0.445,146,380,0.384,169,328,0.515,0.548,237,254,0.933,15,130,145,271,35,9,111,53,1013
Damion Lee,SG,28,GSW,37,1,712,79,177,0.446,52,138,0.377,27,39,0.692,0.593,28,31,0.903,15,110,125,53,25,4,17,55,238
Damyean Dotson,SG,26,CLE,30,6,565,79,197,0.401,29,104,0.279,50,93,0.538,0.475,18,26,0.692,4,49,53,65,12,4,24,26,205
D'Angelo Russell,PG,24,MIN,20,19,583,139,326,0.426,59,148,0.399,80,178,0.449,0.517,48,64,0.75,9,43,52,101,22,10,54,39,385
Daniel Gafford,PF,22,CHI,26,11,343,50,75,0.667,0,0,,50,75,0.667,0.667,26,39,0.667,34,48,82,16,11,32,19,48,126
Daniel Oturu,C,21,LAC,10,0,42,9,15,0.6,0,1,0,9,14,0.643,0.6,2,2,1,5,9,14,4,0,3,2,6,20
Daniel Theis,C,28,BOS,34,29,827,124,220,0.564,27,73,0.37,97,147,0.66,0.625,40,60,0.667,43,127,170,46,21,38,35,98,315
Danilo Gallinari,PF,32,ATL,24,2,525,81,207,0.391,47,121,0.388,34,86,0.395,0.505,71,76,0.934,5,76,81,37,13,3,27,46,280
Danny Green,SF,33,PHI,36,36,1018,106,270,0.393,80,213,0.376,26,57,0.456,0.541,13,20,0.65,31,97,128,61,45,28,46,66,305
Dante Exum,SG,25,CLE,6,3,116,10,26,0.385,2,11,0.182,8,15,0.533,0.423,1,2,0.5,2,15,17,13,4,2,7,9,23
Danuel House,SF,27,HOU,22,12,602,69,184,0.375,34,109,0.312,35,75,0.467,0.467,28,37,0.757,16,71,87,42,14,12,21,43,200
DaQuan Jeffries,SG,23,SAC,12,2,189,22,52,0.423,8,24,0.333,14,28,0.5,0.5,6,7,0.857,7,14,21,4,5,4,5,17,58
Dario Šari?,PF,26,PHO,17,0,307,69,143,0.483,23,61,0.377,46,82,0.561,0.563,34,37,0.919,14,54,68,22,14,3,21,33,195
Darius Bazley,PF,20,OKC,36,36,1104,158,403,0.392,54,186,0.29,104,217,0.479,0.459,57,81,0.704,22,248,270,54,18,23,63,31,427
Darius Garland,PG,21,CLE,28,25,922,179,407,0.44,48,125,0.384,131,282,0.465,0.499,45,53,0.849,13,49,62,164,33,3,82,62,451
Darius Miller,SF,30,OKC,12,0,111,11,24,0.458,9,21,0.429,2,3,0.667,0.646,3,3,1,1,14,15,10,5,4,5,9,34
David Nwaba,SF,28,HOU,28,9,642,100,208,0.481,17,63,0.27,83,145,0.572,0.522,46,66,0.697,37,66,103,28,30,20,17,58,263
De'Aaron Fox,PG,23,SAC,35,35,1198,293,629,0.466,64,187,0.342,229,442,0.518,0.517,156,232,0.672,23,90,113,265,43,17,115,102,806
Dean Wade,PF,24,CLE,28,5,320,33,74,0.446,22,52,0.423,11,22,0.5,0.595,8,12,0.667,13,47,60,18,6,5,12,23,96
Deandre Ayton,C,22,PHO,35,35,1088,218,367,0.594,4,17,0.235,214,350,0.611,0.599,66,88,0.75,118,282,400,59,11,38,61,110,506
DeAndre' Bembry,SF,26,TOR,27,5,443,49,86,0.57,8,22,0.364,41,64,0.641,0.616,14,20,0.7,11,43,54,53,15,8,27,44,120
De'Andre Hunter,SF,23,ATL,18,18,579,108,210,0.514,30,82,0.366,78,128,0.609,0.586,64,73,0.877,16,81,97,40,17,9,25,47,310
DeAndre Jordan,C,32,BRK,35,26,799,115,151,0.762,0,1,0,115,150,0.767,0.762,29,56,0.518,63,199,262,67,11,51,59,76,259
De'Anthony Melton,PG,22,MEM,20,1,408,76,161,0.472,33,78,0.423,43,83,0.518,0.575,16,21,0.762,10,52,62,58,24,14,25,34,201
Deividas Sirvydis,SG,20,DET,5,0,8,0,3,0,0,3,0,0,0,,0,1,2,0.5,0,1,1,1,0,0,0,1,1
Dejounte Murray,PG,24,SAS,32,32,992,207,454,0.456,34,105,0.324,173,349,0.496,0.493,56,69,0.812,19,206,225,172,52,3,53,67,504
Delon Wright,SG,28,DET,29,24,848,110,235,0.468,28,73,0.384,82,162,0.506,0.528,62,79,0.785,32,101,133,141,42,15,35,32,310
DeMar DeRozan,PF,31,SAS,29,29,981,194,401,0.484,16,52,0.308,178,349,0.51,0.504,175,196,0.893,22,120,142,209,25,8,49,55,579
DeMarcus Cousins,C,30,HOU,25,11,506,79,210,0.376,39,116,0.336,40,94,0.426,0.469,44,59,0.746,30,161,191,60,21,18,39,74,241
Deni Avdija,SF,20,WAS,30,16,646,68,157,0.433,31,87,0.356,37,70,0.529,0.532,11,19,0.579,13,127,140,39,20,6,24,75,178
Dennis Schröder,SG,27,LAL,33,33,1030,173,393,0.44,33,104,0.317,140,289,0.484,0.482,113,136,0.831,18,97,115,148,30,8,77,88,492
Dennis Smith Jr.,PG,23,TOT,15,7,275,42,109,0.385,14,44,0.318,28,65,0.431,0.45,11,14,0.786,10,30,40,49,18,8,17,23,109
Dennis Smith Jr.,PG,23,NYK,3,0,28,2,10,0.2,0,4,0,2,6,0.333,0.2,5,6,0.833,0,2,2,3,3,0,1,4,9
Dennis Smith Jr.,PG,23,DET,12,7,247,40,99,0.404,14,40,0.35,26,59,0.441,0.475,6,8,0.75,10,28,38,46,15,8,16,19,100
Denzel Valentine,SG,27,CHI,30,3,591,93,248,0.375,49,141,0.348,44,107,0.411,0.474,6,6,1,12,110,122,54,22,1,18,36,241
Derrick Favors,C,29,UTA,34,0,550,85,131,0.649,0,1,0,85,130,0.654,0.649,45,57,0.789,65,122,187,28,18,31,21,83,215
Derrick Jones Jr.,SF,23,POR,31,30,838,92,182,0.505,26,78,0.333,66,104,0.635,0.577,40,62,0.645,58,91,149,27,24,34,22,74,250
Derrick Rose,PG,32,TOT,25,3,588,126,293,0.43,23,61,0.377,103,232,0.444,0.469,63,74,0.851,7,48,55,112,29,10,48,29,338
Derrick Rose,PG,32,DET,15,0,342,79,184,0.429,13,39,0.333,66,145,0.455,0.465,42,50,0.84,6,23,29,63,18,4,29,17,213
Derrick Rose,PG,32,NYK,10,3,246,47,109,0.431,10,22,0.455,37,87,0.425,0.477,21,24,0.875,1,25,26,49,11,6,19,12,125
Derrick White,SG,26,SAS,8,4,189,34,86,0.395,15,44,0.341,19,42,0.452,0.483,11,15,0.733,1,13,14,31,8,8,7,18,94
Desmond Bane,SG,22,MEM,28,6,639,100,209,0.478,47,106,0.443,53,103,0.515,0.591,21,24,0.875,12,68,80,38,20,4,29,54,268
Devin Booker,SG,24,PHO,31,31,1050,284,573,0.496,63,174,0.362,221,399,0.554,0.551,141,168,0.839,6,107,113,137,28,8,103,93,772
Devin Vassell,SF,20,SAS,26,1,451,50,126,0.397,25,63,0.397,25,63,0.397,0.496,18,21,0.857,16,67,83,28,29,9,12,32,143
Devon Dotson,PG,21,CHI,1,0,10,2,4,0.5,0,0,,2,4,0.5,0.5,0,0,,0,1,1,0,0,0,0,1,4
Devontae Cacok,PF,24,LAL,4,0,17,4,4,1,0,0,,4,4,1,1,0,2,0,1,4,5,0,2,0,2,0,8
Devonte' Graham,PG,25,CHO,25,25,821,109,310,0.352,70,202,0.347,39,108,0.361,0.465,55,71,0.775,14,61,75,142,25,0,35,38,343
Dillon Brooks,SF,25,MEM,29,29,846,176,444,0.396,54,169,0.32,122,275,0.444,0.457,55,66,0.833,28,63,91,76,41,14,59,95,461
Domantas Sabonis,PF,24,IND,35,35,1278,274,522,0.525,32,96,0.333,242,426,0.568,0.556,147,206,0.714,91,298,389,211,36,21,119,120,727
Donovan Mitchell,SG,24,UTA,34,34,1154,288,684,0.421,113,296,0.382,175,388,0.451,0.504,150,182,0.824,37,122,159,183,33,10,101,77,839
Donte DiVincenzo,SG,24,MIL,36,36,960,140,335,0.418,68,177,0.384,72,158,0.456,0.519,21,33,0.636,43,126,169,107,38,8,44,53,369
Dorian Finney-Smith,PF,27,DAL,25,25,787,77,180,0.428,41,119,0.345,36,61,0.59,0.542,10,12,0.833,36,92,128,34,25,10,15,67,205
Doug McDermott,PF,29,IND,34,14,882,174,344,0.506,55,151,0.364,119,193,0.617,0.586,45,55,0.818,34,101,135,45,11,3,33,59,448
Draymond Green,PF,30,GSW,31,31,918,68,174,0.391,14,59,0.237,54,115,0.47,0.431,27,38,0.711,23,165,188,267,44,22,84,100,177
Drew Eubanks,C,23,SAS,15,0,180,21,51,0.412,0,0,,21,51,0.412,0.412,14,20,0.7,9,37,46,9,1,16,8,19,56
Duncan Robinson,SF,26,MIA,36,36,1202,151,352,0.429,117,299,0.391,34,53,0.642,0.595,42,50,0.84,2,140,142,58,17,8,48,90,461
Dwayne Bacon,SG,25,ORL,36,23,886,136,329,0.413,34,102,0.333,102,227,0.449,0.465,57,69,0.826,12,91,103,35,23,3,26,57,363
Dwight Howard,C,35,PHI,36,4,574,81,138,0.587,4,11,0.364,77,127,0.606,0.601,53,100,0.53,91,173,264,27,15,31,62,105,219
Dwight Powell,C,29,DAL,23,8,346,31,67,0.463,1,8,0.125,30,59,0.508,0.47,43,57,0.754,23,50,73,20,13,7,16,53,106
Dylan Windler,SF,24,CLE,22,0,417,47,103,0.456,23,63,0.365,24,40,0.6,0.568,21,26,0.808,17,73,90,28,15,10,22,29,138
Ed Davis,C,31,MIN,19,7,264,18,43,0.419,0,0,,18,43,0.419,0.419,7,8,0.875,38,59,97,19,10,10,6,49,43
Edmond Sumner,SG,25,IND,22,4,251,42,82,0.512,9,26,0.346,33,56,0.589,0.567,20,27,0.741,8,23,31,10,13,2,17,26,113
Elfrid Payton,PG,26,NYK,33,33,932,174,393,0.443,15,60,0.25,159,333,0.477,0.462,55,74,0.743,42,83,125,122,23,7,62,64,418
Elijah Hughes,SF,22,UTA,6,0,27,5,15,0.333,3,10,0.3,2,5,0.4,0.433,3,4,0.75,0,4,4,3,1,1,4,0,16
Enes Kanter,C,28,POR,35,23,919,177,298,0.594,0,0,,177,298,0.594,0.594,63,84,0.75,146,269,415,40,18,26,41,94,417
Eric Bledsoe,SG,31,NOP,35,34,1038,158,363,0.435,69,179,0.385,89,184,0.484,0.53,55,81,0.679,16,108,124,134,28,10,56,54,440
Eric Gordon,SG,32,HOU,26,12,763,153,350,0.437,66,201,0.328,87,149,0.584,0.531,92,110,0.836,7,49,56,70,14,13,50,41,464
Eric Paschall,PF,24,GSW,34,2,599,131,265,0.494,13,45,0.289,118,220,0.536,0.519,61,85,0.718,26,86,112,43,9,4,35,57,336
E'Twaun Moore,SG,31,PHO,22,1,334,40,95,0.421,6,25,0.24,34,70,0.486,0.453,8,10,0.8,11,28,39,35,14,4,18,30,94
Evan Fournier,SF,28,ORL,21,21,613,127,282,0.45,52,140,0.371,75,142,0.528,0.543,83,105,0.79,5,60,65,79,22,7,45,42,389
Facundo Campazzo,PG,29,DEN,30,1,488,51,126,0.405,33,87,0.379,18,39,0.462,0.536,30,37,0.811,5,26,31,62,29,7,25,57,165
Frank Jackson,PG,22,DET,9,0,54,6,22,0.273,4,13,0.308,2,9,0.222,0.364,0,0,,0,8,8,10,1,0,4,5,16
Frank Kaminsky,C,27,PHO,27,11,428,77,165,0.467,26,62,0.419,51,103,0.495,0.545,17,29,0.586,22,84,106,46,8,12,14,38,197
Frank Mason III,PG,26,ORL,4,1,79,9,24,0.375,2,5,0.4,7,19,0.368,0.417,5,7,0.714,3,9,12,12,0,0,5,7,25
Frank Ntilikina,PG,22,NYK,9,1,127,18,37,0.486,13,21,0.619,5,16,0.313,0.662,3,5,0.6,1,6,7,7,8,0,5,15,52
Fred VanVleet,SG,26,TOR,34,34,1249,226,565,0.4,114,298,0.383,112,267,0.419,0.501,118,132,0.894,23,128,151,224,58,27,69,83,684
Furkan Korkmaz,SG,23,PHI,25,3,467,69,180,0.383,39,113,0.345,30,67,0.448,0.492,24,30,0.8,5,56,61,21,15,4,24,30,201
Gabe Vincent,PG,24,MIA,25,5,375,52,143,0.364,23,89,0.258,29,54,0.537,0.444,19,21,0.905,3,24,27,31,12,2,20,46,146
Garrett Temple,SG,34,CHI,33,12,936,107,250,0.428,45,131,0.344,62,119,0.521,0.518,31,38,0.816,20,87,107,68,31,18,33,77,290
Garrison Mathews,SG,24,WAS,28,12,454,53,126,0.421,40,100,0.4,13,26,0.5,0.579,46,50,0.92,11,38,49,13,20,5,4,46,192
Gary Clark,SF,26,ORL,30,11,572,33,112,0.295,26,95,0.274,7,17,0.412,0.411,8,9,0.889,29,66,95,25,11,6,15,31,100
Gary Harris,SG,26,DEN,19,19,581,69,156,0.442,24,75,0.32,45,81,0.556,0.519,22,30,0.733,13,34,47,32,17,4,14,37,184
Gary Trent Jr.,SG,22,POR,33,20,1030,183,433,0.423,101,249,0.406,82,184,0.446,0.539,35,45,0.778,19,52,71,49,25,5,24,53,502
George Hill,PG,34,OKC,14,14,369,61,120,0.508,22,57,0.386,39,63,0.619,0.6,21,25,0.84,8,21,29,43,12,2,12,12,165
Georges Niang,PF,27,UTA,36,0,481,72,167,0.431,45,117,0.385,27,50,0.54,0.566,5,5,1,12,66,78,24,11,3,23,55,194
Giannis Antetokounmpo,PF,26,MIL,35,35,1189,368,661,0.557,39,137,0.285,329,524,0.628,0.586,240,363,0.661,64,344,408,205,44,49,128,106,1015
Glenn Robinson III,SF,27,SAC,23,2,369,42,99,0.424,16,44,0.364,26,55,0.473,0.505,21,23,0.913,11,34,45,20,4,3,11,23,121
Goga Bitadze,C,21,IND,16,0,148,24,47,0.511,2,15,0.133,22,32,0.688,0.532,10,13,0.769,11,21,32,4,3,15,8,26,60
Goran Dragi?,PG,34,MIA,22,8,596,116,253,0.458,35,97,0.361,81,156,0.519,0.528,58,69,0.841,7,59,66,105,13,3,61,58,325
Gordon Hayward,SF,30,CHO,31,31,1080,245,503,0.487,64,158,0.405,181,345,0.525,0.551,114,133,0.857,27,140,167,121,41,12,62,55,668
Gorgui Dieng,C,31,MEM,22,1,371,56,108,0.519,23,48,0.479,33,60,0.55,0.625,38,43,0.884,28,70,98,29,17,14,22,38,173
Grant Williams,PF,22,BOS,28,6,517,54,115,0.47,26,60,0.433,28,55,0.509,0.583,15,29,0.517,27,54,81,25,13,11,27,79,149
Grayson Allen,SG,25,MEM,23,12,551,67,164,0.409,46,113,0.407,21,51,0.412,0.549,34,38,0.895,8,57,65,50,23,3,21,30,214
Greg Whittington,PF,27,DEN,2,0,8,0,2,0,0,2,0,0,0,,0,0,0,,0,0,0,0,0,0,0,0,0
Hamidou Diallo,SG,22,OKC,32,5,761,143,297,0.481,12,41,0.293,131,256,0.512,0.502,83,132,0.629,37,128,165,77,31,12,49,83,381
Harrison Barnes,PF,28,SAC,33,33,1179,184,374,0.492,56,143,0.392,128,231,0.554,0.567,128,155,0.826,33,167,200,118,26,6,47,43,552
Harry Giles,C,22,POR,22,0,260,26,62,0.419,3,8,0.375,23,54,0.426,0.444,13,18,0.722,25,83,108,20,5,9,16,44,68
Hassan Whiteside,C,31,SAC,23,1,335,80,138,0.58,0,1,0,80,137,0.584,0.58,30,55,0.545,36,96,132,11,6,30,24,42,190
Ignas Brazdeikis,SF,22,NYK,4,0,7,0,1,0,0,0,,0,1,0,0,2,2,1,1,1,2,1,0,0,1,0,2
Iman Shumpert,SG,30,BRK,2,0,11,1,4,0.25,0,3,0,1,1,1,0.25,0,0,,1,0,1,0,1,0,1,0,2
Immanuel Quickley,PG,21,NYK,33,0,619,123,316,0.389,59,155,0.381,64,161,0.398,0.483,98,104,0.942,15,62,77,79,15,9,34,64,403
Isaac Bonga,SF,21,WAS,22,7,271,17,45,0.378,10,29,0.345,7,16,0.438,0.489,3,4,0.75,9,35,44,13,6,5,9,33,47
Isaac Okoro,SG,20,CLE,31,31,1030,93,225,0.413,28,93,0.301,65,132,0.492,0.476,36,53,0.679,30,53,83,58,36,16,46,95,250
Isaiah Hartenstein,C,22,DEN,26,0,243,39,76,0.513,0,0,,39,76,0.513,0.513,20,34,0.588,37,37,74,14,10,15,19,53,98
Isaiah Joe,SG,21,PHI,20,1,240,29,79,0.367,23,60,0.383,6,19,0.316,0.513,5,5,1,6,17,23,15,7,4,5,21,86
Isaiah Roby,PF,22,OKC,30,12,640,99,190,0.521,18,53,0.34,81,137,0.591,0.568,42,58,0.724,46,117,163,53,25,17,40,82,258
Isaiah Stewart,C,19,DET,34,2,626,81,146,0.555,1,5,0.2,80,141,0.567,0.558,22,32,0.688,80,116,196,24,18,34,30,88,185
Ish Smith,PG,32,WAS,19,1,391,44,116,0.379,5,20,0.25,39,96,0.406,0.401,6,15,0.4,10,56,66,90,15,4,19,18,99
Ivica Zubac,C,23,LAC,38,1,753,120,182,0.659,0,1,0,120,181,0.663,0.659,71,86,0.826,90,176,266,43,14,30,39,94,311
J.J. Redick,SG,36,NOP,31,0,576,87,214,0.407,51,140,0.364,36,74,0.486,0.526,45,47,0.957,3,49,52,40,9,2,25,37,270
Ja Morant,PG,21,MEM,24,24,738,172,379,0.454,21,90,0.233,151,289,0.522,0.482,110,138,0.797,20,59,79,184,25,4,69,36,475
Jabari Parker,PF,25,SAC,2,0,25,4,7,0.571,0,1,0,4,6,0.667,0.571,0,0,,1,5,6,1,0,1,3,4,8
Jaden McDaniels,PF,20,MIN,30,1,574,57,149,0.383,28,83,0.337,29,66,0.439,0.477,12,23,0.522,18,83,101,30,10,30,23,71,154
Jae Crowder,PF,30,PHO,32,19,883,109,271,0.402,77,205,0.376,32,66,0.485,0.544,29,35,0.829,13,147,160,68,27,8,29,58,324
Jae'Sean Tate,SF,25,HOU,34,22,933,135,252,0.536,22,69,0.319,113,183,0.617,0.579,43,57,0.754,64,115,179,57,32,18,40,104,335
Jahlil Okafor,C,25,DET,12,0,120,25,42,0.595,0,3,0,25,39,0.641,0.595,1,2,0.5,13,14,27,3,2,2,4,10,51
Jahmi'us Ramsey,SG,19,SAC,4,0,16,2,4,0.5,1,3,0.333,1,1,1,0.625,0,0,,0,4,4,1,0,1,1,0,5
JaKarr Sampson,PF,27,IND,15,0,97,15,32,0.469,1,5,0.2,14,27,0.519,0.484,8,10,0.8,8,21,29,1,2,3,6,11,39
Jake Layman,SF,26,MIN,24,4,372,59,115,0.513,15,47,0.319,44,68,0.647,0.578,21,27,0.778,7,30,37,16,20,11,17,27,154
Jakob Poeltl,C,25,SAS,32,14,750,97,159,0.61,0,0,,97,159,0.61,0.61,15,47,0.319,95,139,234,58,20,50,37,70,209
Jalen Brunson,PG,24,DAL,30,7,748,139,262,0.531,39,97,0.402,100,165,0.606,0.605,64,75,0.853,6,99,105,101,16,0,38,45,381
Jalen Harris,SG,22,TOR,2,0,4,0,0,,0,0,,0,0,,,0,0,,1,0,1,0,0,0,1,2,0
Jalen Lecque,PG,20,IND,3,0,9,1,4,0.25,0,1,0,1,3,0.333,0.25,3,3,1,1,3,4,2,0,0,0,0,5
Jalen McDaniels,SF,23,CHO,17,1,213,29,66,0.439,6,23,0.261,23,43,0.535,0.485,13,19,0.684,8,37,45,8,2,4,14,30,77
Jalen Smith,PF,20,PHO,11,0,57,7,19,0.368,2,8,0.25,5,11,0.455,0.421,0,2,0,5,6,11,2,0,2,1,4,16
Jamal Murray,PG,23,DEN,34,34,1204,273,561,0.487,90,226,0.398,183,335,0.546,0.567,104,123,0.846,24,118,142,156,39,11,78,73,740
James Ennis,SF,30,ORL,24,23,514,60,120,0.5,21,47,0.447,39,73,0.534,0.588,33,42,0.786,26,67,93,32,20,6,21,53,174
James Harden,PG-SG,31,TOT,31,31,1173,250,517,0.484,101,252,0.401,149,265,0.562,0.581,183,213,0.859,26,216,242,345,36,21,131,67,784
James Harden,SG,31,HOU,8,8,290,60,135,0.444,25,72,0.347,35,63,0.556,0.537,53,60,0.883,5,36,41,83,7,6,34,14,198
James Harden,PG,31,BRK,23,23,883,190,382,0.497,76,180,0.422,114,202,0.564,0.597,130,153,0.85,21,180,201,262,29,15,97,53,586
James Johnson,PF,33,DAL,27,1,484,65,140,0.464,15,58,0.259,50,82,0.61,0.518,14,26,0.538,12,71,83,47,23,22,26,55,159
James Wiseman,C,19,GSW,26,17,541,126,247,0.51,10,27,0.37,116,220,0.527,0.53,44,70,0.629,36,118,154,17,9,28,38,84,306
JaMychal Green,PF,30,DEN,25,4,512,80,180,0.444,41,96,0.427,39,84,0.464,0.558,27,32,0.844,41,109,150,24,15,7,26,68,228
Jared Dudley,PF,35,LAL,11,0,76,2,7,0.286,2,5,0.4,0,2,0,0.429,0,0,,4,15,19,5,1,1,2,7,6
Jared Harper,PG,23,NYK,2,0,5,0,1,0,0,0,,0,1,0,0,2,2,1,0,0,0,0,0,0,2,0,2
Jarred Vanderbilt,PF,21,MIN,34,17,652,85,139,0.612,1,2,0.5,84,137,0.613,0.615,35,63,0.556,62,133,195,52,38,22,35,73,206
Jarrell Brantley,PF,24,UTA,10,0,28,4,10,0.4,3,7,0.429,1,3,0.333,0.55,0,0,,2,5,7,0,1,1,1,4,11
Jarrett Allen,C,22,TOT,35,17,977,172,257,0.669,4,8,0.5,168,249,0.675,0.677,123,166,0.741,111,235,346,60,16,59,54,55,471
Jarrett Allen,C,22,BRK,12,5,320,44,65,0.677,0,0,,44,65,0.677,0.677,46,61,0.754,38,87,125,20,7,19,22,21,134
Jarrett Allen,C,22,CLE,23,12,657,128,192,0.667,4,8,0.5,124,184,0.674,0.677,77,105,0.733,73,148,221,40,9,40,32,34,337
Jarrett Culver,SG,21,MIN,19,7,376,54,128,0.422,8,35,0.229,46,93,0.495,0.453,21,35,0.6,30,60,90,16,12,7,23,40,137
JaVale McGee,C,33,CLE,27,1,411,85,174,0.489,5,17,0.294,80,157,0.51,0.503,28,46,0.609,42,97,139,26,13,33,36,69,203
Javonte Green,SG,27,BOS,22,2,330,39,71,0.549,7,22,0.318,32,49,0.653,0.599,20,30,0.667,20,30,50,10,18,2,12,29,105
Jaxson Hayes,C,20,NOP,25,1,311,46,68,0.676,0,0,,46,68,0.676,0.676,19,29,0.655,31,58,89,9,9,12,16,45,111
Jaylen Adams,PG,24,MIL,7,0,18,1,8,0.125,0,2,0,1,6,0.167,0.125,0,0,,0,3,3,2,0,0,0,1,2
Jaylen Brown,SG,24,BOS,33,33,1115,305,616,0.495,76,196,0.388,229,420,0.545,0.557,129,167,0.772,37,147,184,129,36,16,93,96,815
Jaylen Nowell,SG,21,MIN,22,0,367,71,170,0.418,25,72,0.347,46,98,0.469,0.491,31,37,0.838,10,32,42,23,10,4,12,40,198
Jayson Tatum,SF,22,BOS,31,31,1110,279,638,0.437,81,220,0.368,198,418,0.474,0.501,134,156,0.859,18,201,219,138,42,15,79,60,773
Jeff Green,C,34,BRK,33,16,870,113,223,0.507,49,116,0.422,64,107,0.598,0.617,39,49,0.796,15,103,118,46,23,8,27,62,314
Jeff Teague,PG,32,BOS,28,4,506,59,158,0.373,19,45,0.422,40,113,0.354,0.434,43,48,0.896,7,39,46,59,23,5,32,34,180
Jerami Grant,SF,26,DET,33,33,1194,254,586,0.433,81,223,0.363,173,363,0.477,0.503,184,207,0.889,24,152,176,96,25,36,62,90,773
Jeremy Lamb,SG,28,IND,21,8,486,78,165,0.473,34,76,0.447,44,89,0.494,0.576,48,51,0.941,15,63,78,34,18,11,16,44,238
Jerome Robinson,SG,23,WAS,13,3,221,22,67,0.328,9,31,0.29,13,36,0.361,0.396,15,17,0.882,2,31,33,18,6,2,11,21,68
Jevon Carter,PG,25,PHO,29,0,289,30,84,0.357,17,57,0.298,13,27,0.481,0.458,2,2,1,3,34,37,35,13,7,5,31,79
Jimmy Butler,SF,31,MIA,22,22,729,143,315,0.454,8,34,0.235,135,281,0.48,0.467,158,183,0.863,44,122,166,172,42,8,51,26,452
Joe Harris,SF,29,BRK,37,33,1144,201,379,0.53,126,249,0.506,75,130,0.577,0.697,21,30,0.7,19,112,131,65,20,7,29,82,549
Joe Ingles,SF,33,UTA,32,9,846,128,245,0.522,79,170,0.465,49,75,0.653,0.684,34,38,0.895,13,94,107,140,15,8,50,56,369
Joel Embiid,C,26,PHI,30,30,990,285,547,0.521,37,89,0.416,248,458,0.541,0.555,298,348,0.856,65,283,348,98,37,41,96,75,905
John Collins,PF,23,ATL,36,36,1104,252,470,0.536,50,129,0.388,202,341,0.592,0.589,93,109,0.853,76,198,274,52,16,35,48,118,647
John Konchar,SG,24,MEM,19,0,308,28,66,0.424,7,23,0.304,21,43,0.488,0.477,16,18,0.889,18,50,68,23,18,5,8,26,79
John Wall,PG,30,HOU,25,25,793,188,443,0.424,51,150,0.34,137,293,0.468,0.482,99,133,0.744,11,70,81,151,22,18,83,29,526
Jonas Valan?i?nas,C,28,MEM,27,26,733,171,317,0.539,10,28,0.357,161,289,0.557,0.555,68,90,0.756,93,213,306,47,16,17,56,83,420
Jordan Bell,C,26,WAS,3,1,50,5,15,0.333,0,2,0,5,13,0.385,0.333,0,0,,5,11,16,5,1,3,3,4,10
Jordan Bone,PG,23,ORL,14,0,196,23,54,0.426,10,32,0.313,13,22,0.591,0.519,0,0,,4,20,24,18,2,0,3,11,56
Jordan Clarkson,SG,28,UTA,36,0,937,237,530,0.447,114,308,0.37,123,222,0.554,0.555,58,60,0.967,31,113,144,82,34,7,62,54,646
Jordan McLaughlin,PG,24,MIN,24,0,467,53,141,0.376,16,46,0.348,37,95,0.389,0.433,8,10,0.8,13,43,56,113,24,4,26,24,130
Jordan Nwora,SF,22,MIL,10,0,82,17,37,0.459,8,16,0.5,9,21,0.429,0.568,9,10,0.9,1,14,15,0,4,2,10,9,51
Jordan Poole,SG,21,GSW,16,0,170,36,77,0.468,18,49,0.367,18,28,0.643,0.584,19,20,0.95,2,19,21,14,4,3,8,14,109
Josh Green,SG,20,DAL,17,5,212,17,36,0.472,2,12,0.167,15,24,0.625,0.5,6,11,0.545,12,27,39,10,4,1,11,16,42
Josh Hall,SF,20,OKC,7,0,51,4,18,0.222,1,8,0.125,3,10,0.3,0.25,3,7,0.429,1,8,9,7,0,0,4,7,12
Josh Hart,SF,25,NOP,36,3,1032,114,254,0.449,49,147,0.333,65,107,0.607,0.545,53,70,0.757,38,226,264,74,29,9,29,87,330
Josh Jackson,SG,23,DET,32,6,797,154,362,0.425,41,141,0.291,113,221,0.511,0.482,84,121,0.694,34,107,141,60,29,28,74,94,433
Josh Okogie,SG,22,MIN,29,20,558,47,134,0.351,12,55,0.218,35,79,0.443,0.396,31,41,0.756,26,47,73,30,24,14,22,58,137
Josh Richardson,SG,27,DAL,25,25,788,114,267,0.427,38,132,0.288,76,135,0.563,0.498,55,58,0.948,22,60,82,63,23,6,37,70,321
Jrue Holiday,PG,30,MIL,26,23,805,159,324,0.491,44,121,0.364,115,203,0.567,0.559,36,47,0.766,31,82,113,133,47,14,42,45,398
Juan Hernangómez,PF,25,MIN,17,6,271,36,90,0.4,16,53,0.302,20,37,0.541,0.489,13,19,0.684,13,62,75,10,6,2,7,14,101
Juan Toscano-Anderson,SG,27,GSW,23,13,474,53,94,0.564,15,35,0.429,38,59,0.644,0.644,13,18,0.722,16,87,103,51,13,12,26,48,134
Julius Randle,PF,26,NYK,37,37,1358,307,636,0.483,69,169,0.408,238,467,0.51,0.537,177,220,0.805,52,357,409,205,29,9,120,115,860
Justin Holiday,SG,31,IND,35,26,1130,139,303,0.459,89,215,0.414,50,88,0.568,0.606,41,50,0.82,22,117,139,60,43,14,28,78,408
Justin Jackson,SF,25,OKC,25,2,405,61,149,0.409,23,79,0.291,38,70,0.543,0.487,16,20,0.8,11,47,58,38,10,1,24,24,161
Justin James,SF,24,SAC,13,0,69,9,23,0.391,2,9,0.222,7,14,0.5,0.435,2,8,0.25,3,6,9,5,3,1,2,3,22
Justin Patton,C,23,HOU,6,2,128,16,31,0.516,6,17,0.353,10,14,0.714,0.613,3,4,0.75,5,19,24,5,7,10,2,19,41
Justise Winslow,SF,24,MEM,6,0,134,24,64,0.375,3,15,0.2,21,49,0.429,0.398,6,10,0.6,5,26,31,9,3,4,10,18,57
Jusuf Nurki,C,26,POR,12,12,280,50,103,0.485,3,12,0.25,47,91,0.516,0.5,15,27,0.556,23,69,92,33,11,11,23,33,118
Juwan Morgan,PF,23,UTA,15,0,71,6,14,0.429,3,10,0.3,3,4,0.75,0.536,1,5,0.2,4,10,14,4,3,0,2,12,16
Karim Mané,PG,20,ORL,6,0,56,1,9,0.111,1,2,0.5,0,7,0,0.167,4,4,1,0,10,10,1,0,1,3,3,7
Karl-Anthony Towns,C,25,MIN,16,16,524,126,255,0.494,30,80,0.375,96,175,0.549,0.553,70,77,0.909,48,127,175,63,14,27,51,60,352
Kawhi Leonard,SF,29,LAC,30,30,1039,287,562,0.511,60,155,0.387,227,407,0.558,0.564,165,189,0.873,28,160,188,146,45,16,58,48,799
Keita Bates-Diop,SF,25,SAS,13,0,107,11,31,0.355,5,14,0.357,6,17,0.353,0.435,7,8,0.875,5,14,19,7,6,1,1,5,34
Kelan Martin,SF,25,IND,12,0,48,7,20,0.35,2,9,0.222,5,11,0.455,0.4,2,2,1,1,11,12,0,3,0,4,5,18
Keldon Johnson,SF,21,SAS,29,27,845,151,320,0.472,28,86,0.326,123,234,0.526,0.516,79,101,0.782,47,146,193,63,22,14,41,66,409
Keljin Blevins,SF,25,POR,9,0,47,2,11,0.182,0,4,0,2,7,0.286,0.182,0,0,,0,2,2,4,2,0,3,4,4
Kelly Olynyk,C,29,MIA,35,30,927,132,299,0.441,66,201,0.328,66,98,0.673,0.552,22,30,0.733,32,173,205,75,28,19,46,98,352
Kelly Oubre Jr.,SF,25,GSW,35,35,1062,202,463,0.436,60,187,0.321,142,276,0.514,0.501,77,104,0.74,51,157,208,49,39,27,45,77,541
Kemba Walker,PG,30,BOS,20,20,600,123,317,0.388,59,161,0.366,64,156,0.41,0.481,64,70,0.914,8,64,72,91,21,7,44,27,369
Kendrick Nunn,PG,25,MIA,28,16,839,152,330,0.461,58,159,0.365,94,171,0.55,0.548,36,39,0.923,14,80,94,76,33,9,50,54,398
Kenrich Williams,PF,26,OKC,36,6,681,93,168,0.554,21,50,0.42,72,118,0.61,0.616,15,24,0.625,48,97,145,59,28,7,33,64,222
Kent Bazemore,SF,31,GSW,35,1,587,84,175,0.48,39,89,0.438,45,86,0.523,0.591,24,32,0.75,14,91,105,56,30,19,38,77,231
Kentavious Caldwell-Pope,SG,27,LAL,33,33,863,98,224,0.438,51,127,0.402,47,97,0.485,0.551,39,46,0.848,15,63,78,47,26,9,34,55,286
Kenyon Martin Jr.,SF,20,HOU,7,0,69,10,27,0.37,1,4,0.25,9,23,0.391,0.389,2,5,0.4,8,11,19,4,2,5,5,9,23
Kevin Durant,PF,32,BRK,19,18,679,188,359,0.524,49,113,0.434,139,246,0.565,0.592,126,145,0.869,7,132,139,100,14,27,67,43,551
Kevin Huerter,SG,22,ATL,36,25,1157,165,387,0.426,77,211,0.365,88,176,0.5,0.526,28,34,0.824,26,105,131,133,46,7,47,87,435
Kevin Knox,SF,21,NYK,26,0,397,47,119,0.395,28,72,0.389,19,47,0.404,0.513,11,14,0.786,9,40,49,17,8,6,16,33,133
Kevin Love,PF,32,CLE,2,2,46,6,18,0.333,3,9,0.333,3,9,0.333,0.417,4,5,0.8,2,10,12,5,1,0,3,1,19
Kevon Looney,C,24,GSW,27,10,401,44,74,0.595,2,6,0.333,42,68,0.618,0.608,16,21,0.762,48,65,113,43,10,8,17,50,106
Khem Birch,C,28,ORL,35,1,703,76,153,0.497,4,13,0.308,72,140,0.514,0.51,51,69,0.739,90,97,187,37,21,25,19,54,207
Khris Middleton,SF,29,MIL,36,36,1203,272,549,0.495,83,192,0.432,189,357,0.529,0.571,114,129,0.884,31,190,221,206,40,6,93,92,741
Killian Hayes,PG,19,DET,7,7,148,13,47,0.277,5,20,0.25,8,27,0.296,0.33,1,2,0.5,1,7,8,25,2,0,17,15,32
Killian Tillie,C,22,MEM,2,0,21,1,4,0.25,1,2,0.5,0,2,0,0.375,0,0,,1,1,2,0,1,0,1,5,3
Kira Lewis Jr.,PG,19,NOP,21,0,273,42,108,0.389,13,39,0.333,29,69,0.42,0.449,13,20,0.65,2,15,17,38,12,1,9,25,110
Kostas Antetokounmpo,PF,23,LAL,3,0,19,1,3,0.333,0,0,,1,3,0.333,0.333,1,2,0.5,2,6,8,0,1,2,5,3,3
Kristaps Porzi??is,C,25,DAL,20,20,602,151,322,0.469,44,126,0.349,107,196,0.546,0.537,57,68,0.838,37,130,167,27,8,31,25,59,403
Kyle Anderson,PF,27,MEM,30,30,829,146,306,0.477,46,121,0.38,100,185,0.541,0.552,64,84,0.762,28,155,183,105,36,21,46,54,402
Kyle Guy,PG,23,SAC,14,0,115,14,44,0.318,6,24,0.25,8,20,0.4,0.386,7,8,0.875,3,11,14,15,4,0,3,9,41
Kyle Kuzma,SF,25,LAL,36,11,932,162,365,0.444,65,178,0.365,97,187,0.519,0.533,24,38,0.632,75,165,240,41,14,23,54,63,413
Kyle Lowry,PG,34,TOR,29,29,1002,174,381,0.457,83,206,0.403,91,175,0.52,0.566,91,106,0.858,24,136,160,204,34,6,82,94,522
Kyrie Irving,PG,28,BRK,26,26,924,269,527,0.51,76,185,0.411,193,342,0.564,0.583,94,106,0.887,31,93,124,155,28,16,59,74,708
KZ Okpala,PF,21,MIA,19,6,199,14,40,0.35,8,24,0.333,6,16,0.375,0.45,2,6,0.333,8,21,29,7,3,4,9,24,38
Lamar Stevens,PF,23,CLE,24,0,346,38,94,0.404,2,17,0.118,36,77,0.468,0.415,23,32,0.719,12,51,63,23,11,8,15,35,101
LaMarcus Aldridge,C,35,SAS,21,18,544,115,248,0.464,27,75,0.36,88,173,0.509,0.518,31,37,0.838,17,77,94,36,8,18,20,36,288
LaMelo Ball,PG,19,CHO,35,15,1010,201,448,0.449,70,185,0.378,131,263,0.498,0.527,81,101,0.802,51,160,211,221,57,13,99,95,553
Landry Shamet,SG,23,BRK,33,0,650,83,216,0.384,58,162,0.358,25,54,0.463,0.519,33,38,0.868,5,56,61,37,15,5,26,42,257
Langston Galloway,SG,29,PHO,25,0,262,38,82,0.463,21,46,0.457,17,36,0.472,0.591,16,16,1,4,22,26,16,4,0,7,14,113
Larry Nance Jr.,PF,28,CLE,19,18,635,70,145,0.483,24,63,0.381,46,82,0.561,0.566,12,21,0.571,27,102,129,61,37,10,28,41,176
Lauri Markkanen,PF,23,CHI,14,14,426,95,185,0.514,40,101,0.396,55,84,0.655,0.622,38,45,0.844,8,77,85,12,9,5,24,31,268
LeBron James,PG,36,LAL,36,36,1245,350,687,0.509,86,240,0.358,264,447,0.591,0.572,144,208,0.692,21,268,289,280,41,22,135,56,930
Lonnie Walker,SG,22,SAS,30,27,819,127,316,0.402,53,148,0.358,74,168,0.44,0.486,32,40,0.8,6,80,86,53,15,13,32,64,339
Lonzo Ball,PG,23,NOP,33,33,1048,175,409,0.428,99,256,0.387,76,153,0.497,0.549,31,40,0.775,20,117,137,168,43,18,66,71,480
Lou Williams,PG,34,LAC,35,3,794,158,374,0.422,39,98,0.398,119,276,0.431,0.475,83,96,0.865,14,67,81,130,30,3,57,34,438
Luguentz Dort,SG,21,OKC,35,35,1040,149,384,0.388,68,209,0.325,81,175,0.463,0.477,66,88,0.75,24,97,121,51,31,10,52,85,432
Luka Don?i?,PG,21,DAL,32,32,1125,319,668,0.478,85,238,0.357,234,430,0.544,0.541,193,255,0.757,27,242,269,287,32,22,133,64,916
Luka Šamani?,PF,21,SAS,9,1,99,15,34,0.441,8,20,0.4,7,14,0.5,0.559,4,8,0.5,6,22,28,1,3,2,6,10,42
Luke Kennard,SG,24,LAC,34,7,684,94,203,0.463,52,114,0.456,42,89,0.472,0.591,13,15,0.867,8,82,90,58,11,6,29,54,253
Luke Kornet,PF,25,CHI,10,0,83,9,26,0.346,6,22,0.273,3,4,0.75,0.462,2,2,1,1,14,15,4,2,6,1,1,26
Malachi Flynn,PG,22,TOR,15,0,125,12,45,0.267,5,26,0.192,7,19,0.368,0.322,4,6,0.667,1,10,11,16,4,0,4,12,33
Malcolm Brogdon,PG,28,IND,34,34,1211,276,617,0.447,82,217,0.378,194,400,0.485,0.514,87,97,0.897,27,131,158,212,40,8,71,64,721
Malik Beasley,SG,24,MIN,33,32,1093,250,550,0.455,116,286,0.406,134,264,0.508,0.56,61,72,0.847,27,126,153,81,27,6,54,54,677
Malik Monk,SG,22,CHO,22,0,499,103,223,0.462,54,123,0.439,49,100,0.49,0.583,37,47,0.787,8,55,63,41,6,2,33,32,297
Marc Gasol,C,36,LAL,35,35,703,54,134,0.403,31,85,0.365,23,49,0.469,0.519,29,36,0.806,25,118,143,69,17,45,30,82,168
Marcus Morris,PF,31,LAC,28,2,684,121,275,0.44,65,140,0.464,56,135,0.415,0.558,38,42,0.905,20,86,106,25,15,8,25,52,345
Marcus Smart,PG,26,BOS,17,17,549,74,188,0.394,28,90,0.311,46,98,0.469,0.468,46,62,0.742,7,40,47,103,31,9,30,39,222
Markelle Fultz,PG,22,ORL,8,8,215,41,104,0.394,4,16,0.25,37,88,0.42,0.413,17,19,0.895,5,20,25,43,8,2,18,18,103
Markieff Morris,PF,31,LAL,31,7,539,59,145,0.407,28,87,0.322,31,58,0.534,0.503,20,29,0.69,22,95,117,31,7,8,18,50,166
Markus Howard,SG,21,DEN,17,0,55,6,31,0.194,3,22,0.136,3,9,0.333,0.242,1,2,0.5,0,5,5,6,2,0,4,7,16
Marques Bolden,C,22,CLE,6,0,29,1,3,0.333,0,0,,1,3,0.333,0.333,5,8,0.625,3,3,6,0,2,2,2,0,7
Marquese Chriss,PF,23,GSW,2,0,27,5,14,0.357,1,5,0.2,4,9,0.444,0.393,2,4,0.5,3,10,13,2,0,2,2,3,13
Marvin Bagley III,PF,21,SAC,34,34,888,195,390,0.5,34,92,0.37,161,298,0.54,0.544,54,102,0.529,83,175,258,33,18,16,47,82,478
Mason Jones,SG,22,HOU,22,1,244,38,87,0.437,18,49,0.367,20,38,0.526,0.54,28,43,0.651,4,42,46,29,6,0,26,22,122
Mason Plumlee,C,30,DET,34,34,953,145,239,0.607,0,6,0,145,233,0.622,0.607,64,95,0.674,94,217,311,130,28,29,72,120,354
Matisse Thybulle,SG,23,PHI,33,2,596,39,106,0.368,17,65,0.262,22,41,0.537,0.448,8,14,0.571,12,36,48,31,46,30,13,66,103
Matt Thomas,SG,26,TOR,21,0,145,18,46,0.391,12,31,0.387,6,15,0.4,0.522,5,6,0.833,1,13,14,9,2,0,5,8,53
Maurice Harkless,SF,27,MIA,10,3,109,4,10,0.4,4,8,0.5,0,2,0,0.6,0,2,0,1,8,9,7,2,3,2,12,12
Max Strus,SF,24,MIA,19,0,283,47,103,0.456,31,85,0.365,16,18,0.889,0.607,10,14,0.714,2,18,20,10,3,0,3,24,135
Maxi Kleber,PF,29,DAL,22,16,569,48,109,0.44,37,82,0.451,11,27,0.407,0.61,22,23,0.957,19,98,117,30,10,20,12,50,155
Meyers Leonard,C,28,MIA,3,2,29,3,7,0.429,3,7,0.429,0,0,,0.643,1,2,0.5,0,7,7,2,0,0,2,5,10
Mfiondu Kabengele,PF,23,LAC,20,0,81,7,26,0.269,3,15,0.2,4,11,0.364,0.327,3,4,0.75,1,10,11,5,2,3,5,14,20
Michael Carter-Williams,SG,29,ORL,17,12,450,58,144,0.403,8,31,0.258,50,113,0.442,0.431,29,38,0.763,27,55,82,70,10,9,32,50,153
Michael Porter Jr.,SF,22,DEN,26,19,744,142,283,0.502,62,149,0.416,80,134,0.597,0.611,34,45,0.756,32,151,183,23,23,28,29,60,380
Mikal Bridges,SF,24,PHO,35,35,1131,172,328,0.524,66,157,0.42,106,171,0.62,0.625,69,82,0.841,47,130,177,77,25,33,27,56,479
Mike Conley,PG,33,UTA,29,29,853,161,363,0.444,81,192,0.422,80,171,0.468,0.555,63,76,0.829,28,73,101,164,42,3,54,56,466
Mike Muscala,C,29,OKC,34,0,633,116,263,0.441,67,182,0.368,49,81,0.605,0.568,32,35,0.914,19,110,129,27,8,11,21,53,331
Mike Scott,PF,32,PHI,17,4,295,26,63,0.413,19,50,0.38,7,13,0.538,0.563,2,5,0.4,4,43,47,5,8,2,10,17,73
Miles Bridges,PF,22,CHO,35,2,937,132,269,0.491,46,120,0.383,86,149,0.577,0.576,41,44,0.932,45,155,200,73,25,25,60,83,351
Mitchell Robinson,C,22,NYK,27,27,778,103,156,0.66,0,0,,103,156,0.66,0.66,22,46,0.478,97,129,226,14,32,41,22,78,228
Miye Oni,SG,23,UTA,26,0,206,14,38,0.368,13,33,0.394,1,5,0.2,0.539,5,6,0.833,14,32,46,6,3,4,7,29,46
Mo Bamba,C,22,ORL,17,0,161,35,67,0.522,7,19,0.368,28,48,0.583,0.575,4,6,0.667,19,46,65,4,3,13,7,21,81
Monte Morris,PG,25,DEN,35,9,949,142,298,0.477,40,111,0.36,102,187,0.545,0.544,46,61,0.754,7,69,76,118,24,10,24,33,370
Montrezl Harrell,C,27,LAL,37,1,891,209,334,0.626,0,6,0,209,328,0.637,0.626,93,123,0.756,89,149,238,39,24,27,41,77,511
Moritz Wagner,C,23,WAS,22,11,315,56,105,0.533,12,35,0.343,44,70,0.629,0.59,33,44,0.75,11,55,66,26,16,6,14,50,157
Moses Brown,C,21,OKC,7,0,31,7,10,0.7,0,0,,7,10,0.7,0.7,7,14,0.5,4,11,15,3,1,4,1,4,21
Mychal Mulder,PG,26,GSW,34,2,360,47,108,0.435,38,93,0.409,9,15,0.6,0.611,8,15,0.533,1,30,31,15,8,7,8,27,140
Myles Turner,C,24,IND,33,33,1038,156,322,0.484,48,153,0.314,108,169,0.639,0.559,84,108,0.778,45,171,216,30,34,111,45,117,444
Naji Marshall,SF,23,NOP,3,0,8,0,2,0,0,1,0,0,1,0,0,1,2,0.5,0,2,2,1,0,0,0,0,1
Nassir Little,PF,20,POR,20,2,239,33,70,0.471,17,37,0.459,16,33,0.485,0.593,22,25,0.88,14,31,45,7,3,5,10,21,105
Nate Hinton,SG,21,DAL,6,0,19,3,13,0.231,1,5,0.2,2,8,0.25,0.269,1,2,0.5,0,0,0,0,1,1,2,1,8
Nathan Knight,PF,23,ATL,10,0,58,9,23,0.391,3,9,0.333,6,14,0.429,0.457,7,8,0.875,8,7,15,1,2,3,5,7,28
Naz Reid,C,21,MIN,34,13,699,158,307,0.515,32,94,0.34,126,213,0.592,0.567,55,75,0.733,39,123,162,44,21,41,38,104,403
Nemanja Bjelica,PF,32,SAC,19,1,342,58,120,0.483,15,45,0.333,43,75,0.573,0.546,30,38,0.789,20,60,80,42,6,2,24,36,161
Nerlens Noel,C,26,NYK,32,10,710,68,111,0.613,0,2,0,68,109,0.624,0.613,22,33,0.667,68,127,195,20,32,65,37,83,158
Nick Richards,PF,23,CHO,8,0,23,3,6,0.5,0,0,,3,6,0.5,0.5,5,6,0.833,2,4,6,0,0,0,1,4,11
Nickeil Alexander-Walker,SG,22,NOP,28,3,495,86,211,0.408,30,98,0.306,56,113,0.496,0.479,28,35,0.8,5,61,66,54,28,9,32,44,230
Nico Mannion,PG,19,GSW,7,1,67,6,23,0.261,5,14,0.357,1,9,0.111,0.37,1,4,0.25,0,12,12,18,3,0,7,8,18
Nicolas Batum,SF,32,LAC,35,35,1031,108,229,0.472,68,155,0.439,40,74,0.541,0.62,30,36,0.833,30,137,167,84,42,13,26,59,314
Nicolas Claxton,C,21,BRK,5,0,76,20,29,0.69,0,1,0,20,28,0.714,0.69,10,14,0.714,4,13,17,5,5,7,2,8,50
Nicolò Melli,PF,30,NOP,17,0,186,9,40,0.225,7,33,0.212,2,7,0.286,0.313,4,5,0.8,3,35,38,16,8,1,7,22,29
Nikola Joki?,C,25,DEN,36,36,1293,379,668,0.567,56,134,0.418,323,534,0.605,0.609,163,185,0.881,101,296,397,309,58,23,114,107,977
Nikola Vu?evi?,C,30,ORL,36,36,1220,355,735,0.483,96,233,0.412,259,502,0.516,0.548,80,94,0.851,69,348,417,134,36,23,60,62,886
Noah Vonleh,PF,25,BRK,4,0,11,0,3,0,0,2,0,0,1,0,0,0,0,,0,1,1,1,0,0,2,2,0
Norman Powell,SG,27,TOR,34,23,1006,211,432,0.488,88,201,0.438,123,231,0.532,0.59,116,129,0.899,15,87,102,59,40,5,59,73,626
Norvel Pelle,C,27,TOT,4,0,32,3,8,0.375,0,0,,3,8,0.375,0.375,3,4,0.75,4,4,8,1,0,3,3,10,9
Norvel Pelle,C,27,BRK,3,0,28,3,7,0.429,0,0,,3,7,0.429,0.429,0,0,,3,4,7,0,0,3,3,9,6
Norvel Pelle,C,27,SAC,1,0,4,0,1,0,0,0,,0,1,0,0,3,4,0.75,1,0,1,1,0,0,0,1,3
Obi Toppin,PF,22,NYK,27,0,342,52,107,0.486,13,44,0.295,39,63,0.619,0.547,10,14,0.714,9,58,67,15,8,10,15,28,127
OG Anunoby,SF,23,TOR,23,23,769,114,238,0.479,49,124,0.395,65,114,0.57,0.582,40,53,0.755,33,99,132,38,37,17,38,64,317
Onyeka Okongwu,C,20,ATL,16,1,159,21,37,0.568,0,1,0,21,36,0.583,0.568,9,15,0.6,12,27,39,5,6,7,8,26,51
Otto Porter,SF,27,CHI,16,6,372,64,144,0.444,28,70,0.4,36,74,0.486,0.542,30,36,0.833,20,80,100,32,9,3,15,25,186
P.J. Tucker,PF,35,HOU,32,32,959,48,131,0.366,27,86,0.314,21,45,0.467,0.469,18,23,0.783,33,115,148,45,29,18,33,91,141
P.J. Washington,PF,22,CHO,31,31,910,137,305,0.449,42,109,0.385,95,196,0.485,0.518,70,90,0.778,45,151,196,90,34,36,65,83,386
Pascal Siakam,PF,26,TOR,30,30,1075,222,490,0.453,36,122,0.295,186,368,0.505,0.49,122,149,0.819,58,166,224,143,35,21,65,93,602
Pat Connaughton,SG,28,MIL,33,0,697,78,176,0.443,46,117,0.393,32,59,0.542,0.574,14,17,0.824,31,110,141,46,22,15,12,52,216
Patrick Beverley,PG,32,LAC,28,28,678,79,177,0.446,49,116,0.422,30,61,0.492,0.585,31,39,0.795,27,80,107,60,25,22,27,90,238
Patrick McCaw,SF,25,TOR,3,0,20,0,0,,0,0,,0,0,,,0,0,,1,0,1,4,0,0,0,3,0
Patrick Patterson,PF,31,LAC,10,1,130,16,38,0.421,10,28,0.357,6,10,0.6,0.553,3,4,0.75,4,16,20,5,3,1,7,13,45
Patrick Williams,PF,19,CHI,33,33,939,127,268,0.474,30,77,0.39,97,191,0.508,0.53,52,66,0.788,30,129,159,39,24,25,49,75,336
Patty Mills,PG,32,SAS,32,0,824,151,337,0.448,88,219,0.402,63,118,0.534,0.579,36,40,0.9,10,48,58,85,20,1,34,46,426
Paul George,SF,30,LAC,27,27,904,225,451,0.499,95,211,0.45,130,240,0.542,0.604,95,107,0.888,24,141,165,146,30,14,91,63,640
Paul Millsap,PF,35,DEN,26,26,621,99,189,0.524,32,78,0.41,67,111,0.604,0.608,41,59,0.695,41,93,134,43,22,14,26,54,271
Paul Reed,PF,21,PHI,5,0,55,9,22,0.409,0,3,0,9,19,0.474,0.409,0,0,,7,3,10,3,1,4,5,4,18
Paul Watson,SF,26,TOR,16,0,74,10,20,0.5,9,17,0.529,1,3,0.333,0.725,0,0,,2,12,14,2,0,2,1,9,29
Payton Pritchard,SG,23,BOS,30,1,641,86,188,0.457,41,102,0.402,45,86,0.523,0.566,17,18,0.944,16,54,70,69,18,5,34,59,230
PJ Dozier,SG,24,DEN,21,0,408,58,127,0.457,20,51,0.392,38,76,0.5,0.535,23,38,0.605,18,64,82,35,11,13,16,36,159
Precious Achiuwa,PF,21,MIA,35,2,491,84,145,0.579,0,0,,84,145,0.579,0.579,44,81,0.543,46,95,141,20,15,19,32,58,212
Quinn Cook,PG,27,LAL,16,0,62,12,26,0.462,5,13,0.385,7,13,0.538,0.558,4,5,0.8,0,5,5,5,1,1,3,2,33
Quinndary Weatherspoon,SG,24,SAS,5,0,24,1,5,0.2,0,1,0,1,4,0.25,0.2,2,2,1,0,2,2,3,1,0,6,7,4
R.J. Hampton,PG,19,DEN,24,0,220,24,58,0.414,5,18,0.278,19,40,0.475,0.457,7,10,0.7,10,37,47,12,5,2,11,21,60
Rajon Rondo,PG,34,ATL,20,2,300,29,74,0.392,13,34,0.382,16,40,0.4,0.48,1,2,0.5,4,40,44,70,12,2,27,18,72
Raul Neto,PG,28,WAS,29,6,591,88,196,0.449,28,75,0.373,60,121,0.496,0.52,25,30,0.833,13,53,66,60,33,2,21,39,229
Ray Spalding,C,23,HOU,2,0,19,2,4,0.5,0,1,0,2,3,0.667,0.5,0,2,0,2,2,4,0,0,2,3,3,4
Reggie Bullock,SF,29,NYK,32,32,841,99,244,0.406,55,148,0.372,44,96,0.458,0.518,20,24,0.833,10,99,109,42,20,7,23,69,273
Reggie Jackson,SG,30,LAC,35,16,709,114,250,0.456,46,115,0.4,68,135,0.504,0.548,31,41,0.756,13,77,90,103,20,3,35,65,305
Reggie Perry,PF,20,BRK,14,0,147,21,51,0.412,2,12,0.167,19,39,0.487,0.431,6,9,0.667,17,34,51,12,2,5,11,27,50
Richaun Holmes,C,27,SAC,32,32,942,179,275,0.651,1,6,0.167,178,269,0.662,0.653,58,72,0.806,81,185,266,55,23,48,43,127,417
Ricky Rubio,PG,30,MIN,34,19,863,92,236,0.39,27,82,0.329,65,154,0.422,0.447,61,74,0.824,14,93,107,218,42,0,70,77,272
RJ Barrett,SG,20,NYK,37,37,1227,233,526,0.443,43,123,0.35,190,403,0.471,0.484,103,141,0.73,45,176,221,109,24,8,70,96,612
Robert Covington,PF,30,POR,33,33,1054,91,243,0.374,57,171,0.333,34,72,0.472,0.492,23,28,0.821,27,191,218,55,53,39,40,85,262
Robert Williams,C,23,BOS,29,0,468,88,122,0.721,0,1,0,88,121,0.727,0.721,25,39,0.641,66,104,170,31,26,42,28,53,201
Robert Woodard,SF,21,SAC,6,0,17,6,11,0.545,1,3,0.333,5,8,0.625,0.591,0,2,0,3,5,8,0,0,0,1,0,13
Robin Lopez,C,32,WAS,34,9,690,112,189,0.593,4,13,0.308,108,176,0.614,0.603,53,76,0.697,78,66,144,32,10,21,37,65,281
Rodions Kurucs,SF-PF,22,TOT,16,0,91,6,24,0.25,3,17,0.176,3,7,0.429,0.313,1,2,0.5,2,12,14,6,6,4,9,8,16
Rodions Kurucs,PF,22,BRK,5,0,16,1,3,0.333,1,2,0.5,0,1,0,0.5,0,0,,0,3,3,2,0,0,0,1,3
Rodions Kurucs,SF,22,HOU,11,0,75,5,21,0.238,2,15,0.133,3,6,0.5,0.286,1,2,0.5,2,9,11,4,6,4,9,7,13
Rodney Hood,SF,28,POR,30,5,575,62,168,0.369,20,67,0.299,42,101,0.416,0.429,5,8,0.625,8,42,50,32,17,3,25,42,149
Rodney McGruder,SG,29,DET,12,0,115,22,43,0.512,8,16,0.5,14,27,0.519,0.605,5,6,0.833,4,8,12,12,4,1,6,8,57
Royce O'Neale,SF,27,UTA,36,36,1181,94,213,0.441,62,151,0.411,32,62,0.516,0.587,23,28,0.821,45,199,244,94,28,20,42,102,273
Rudy Gay,PF,34,SAS,26,0,572,108,258,0.419,41,112,0.366,67,146,0.459,0.498,33,43,0.767,24,111,135,39,18,13,30,47,290
Rudy Gobert,C,28,UTA,36,36,1105,196,306,0.641,0,1,0,196,305,0.643,0.641,118,197,0.599,120,352,472,48,17,98,64,82,510
Rui Hachimura,PF,22,WAS,27,27,813,122,267,0.457,21,69,0.304,101,198,0.51,0.496,72,95,0.758,29,118,147,47,19,2,28,61,337
Russell Westbrook,PG,32,WAS,27,27,923,211,493,0.428,30,102,0.294,181,391,0.463,0.458,95,163,0.583,44,219,263,265,31,9,130,79,547
Ryan Arcidiacono,PG,26,CHI,18,0,198,21,50,0.42,11,32,0.344,10,18,0.556,0.53,8,9,0.889,2,31,33,23,5,0,4,16,61
Saben Lee,PG,21,DET,15,0,238,38,70,0.543,4,6,0.667,34,64,0.531,0.571,26,39,0.667,6,17,23,35,11,5,14,25,106
Saddiq Bey,SF,21,DET,34,17,778,108,264,0.409,72,183,0.393,36,81,0.444,0.545,48,56,0.857,18,115,133,39,21,1,23,54,336
Sam Merrill,SG,24,MIL,13,0,77,6,17,0.353,5,11,0.455,1,6,0.167,0.5,2,2,1,4,10,14,11,2,0,3,6,19
Sean McDermott,SF,24,MEM,8,0,126,10,23,0.435,5,15,0.333,5,8,0.625,0.543,6,6,1,4,8,12,4,1,2,4,6,31
Sekou Doumbouya,PF,20,DET,32,2,439,50,141,0.355,15,60,0.25,35,81,0.432,0.408,19,26,0.731,16,57,73,22,13,2,18,50,134
Semi Ojeleye,PF,26,BOS,34,6,645,63,151,0.417,41,107,0.383,22,44,0.5,0.553,20,28,0.714,20,78,98,27,11,0,14,41,187
Serge Ibaka,C,31,LAC,37,37,887,169,333,0.508,37,104,0.356,132,229,0.576,0.563,36,44,0.818,62,184,246,66,9,46,42,73,411
Seth Curry,SG,30,PHI,28,28,836,123,262,0.469,56,125,0.448,67,137,0.489,0.576,48,52,0.923,5,51,56,77,25,8,41,48,350
Shai Gilgeous-Alexander,SG,22,OKC,30,30,1020,239,468,0.511,61,148,0.412,178,320,0.556,0.576,158,199,0.794,17,136,153,187,23,20,87,60,697
Shake Milton,SG,24,PHI,28,1,703,135,306,0.441,31,99,0.313,104,207,0.502,0.492,86,97,0.887,17,43,60,85,18,7,43,64,387
Shaquille Harrison,SG,27,UTA,17,0,56,6,20,0.3,0,2,0,6,18,0.333,0.3,5,6,0.833,3,6,9,9,2,0,5,3,17
Sindarius Thornwell,SG,26,NOP,11,1,53,6,13,0.462,3,6,0.5,3,7,0.429,0.577,0,2,0,1,2,3,2,4,0,2,3,15
Skylar Mays,SG,23,ATL,16,0,132,19,49,0.388,8,23,0.348,11,26,0.423,0.469,16,18,0.889,6,6,12,18,6,0,4,6,62
Solomon Hill,PF,29,ATL,36,1,686,53,149,0.356,35,110,0.318,18,39,0.462,0.473,15,17,0.882,18,64,82,33,25,6,21,58,156
Spencer Dinwiddie,SG,27,BRK,3,3,64,6,16,0.375,2,7,0.286,4,9,0.444,0.438,6,6,1,0,13,13,9,2,1,5,4,20
Stanley Johnson,PF,24,TOR,32,2,441,31,79,0.392,20,50,0.4,11,29,0.379,0.519,11,14,0.786,15,54,69,41,24,9,22,49,93
Stephen Curry,PG,32,GSW,35,35,1194,343,718,0.478,169,411,0.411,174,307,0.567,0.595,184,197,0.934,17,174,191,221,46,2,111,64,1039
Sterling Brown,SG,25,HOU,32,2,713,86,196,0.439,51,127,0.402,35,69,0.507,0.569,14,15,0.933,22,112,134,55,31,7,25,64,237
Steven Adams,C,27,NOP,33,33,918,115,187,0.615,0,1,0,115,186,0.618,0.615,35,79,0.443,133,161,294,69,29,20,50,63,265
Sviatoslav Mykhailiuk,SF,23,DET,35,4,608,80,212,0.377,54,161,0.335,26,51,0.51,0.505,24,30,0.8,11,59,70,49,25,6,38,31,238
T.J. McConnell,PG,28,IND,32,2,810,100,190,0.526,6,19,0.316,94,171,0.55,0.542,9,18,0.5,22,95,117,216,63,12,60,50,215
T.J. Warren,SF,27,IND,4,4,117,27,51,0.529,0,7,0,27,44,0.614,0.529,8,10,0.8,2,12,14,5,2,0,4,16,62
Tacko Fall,C,25,BOS,8,0,57,9,13,0.692,0,0,,9,13,0.692,0.692,3,8,0.375,8,13,21,1,0,10,1,10,21
Taj Gibson,PF,35,NYK,12,0,181,18,31,0.581,2,7,0.286,16,24,0.667,0.613,7,12,0.583,18,33,51,6,5,4,7,23,45
Talen Horton-Tucker,SG,20,LAL,33,1,576,94,213,0.441,18,63,0.286,76,150,0.507,0.484,32,39,0.821,10,70,80,66,27,19,43,69,238
Taurean Prince,PF,26,TOT,29,10,620,79,208,0.38,39,101,0.386,40,107,0.374,0.474,45,53,0.849,15,89,104,50,19,19,31,53,242
Taurean Prince,PF,26,BRK,12,4,218,30,74,0.405,13,37,0.351,17,37,0.459,0.493,24,27,0.889,2,32,34,7,8,8,11,21,97
Taurean Prince,PF,26,CLE,17,6,402,49,134,0.366,26,64,0.406,23,70,0.329,0.463,21,26,0.808,13,57,70,43,11,11,20,32,145
Terance Mann,SG,24,LAC,35,3,549,62,129,0.481,13,34,0.382,49,95,0.516,0.531,32,40,0.8,31,83,114,45,14,6,23,59,169
Terence Davis,SG,23,TOR,30,3,442,79,187,0.422,40,110,0.364,39,77,0.506,0.529,16,18,0.889,9,49,58,32,16,6,24,46,214
Terrance Ferguson,SG,22,PHI,9,0,34,1,5,0.2,0,3,0,1,2,0.5,0.2,0,0,,0,1,1,2,0,0,3,5,2
Terrence Ross,SG,29,ORL,35,2,1032,195,476,0.41,73,212,0.344,122,264,0.462,0.486,81,90,0.9,12,110,122,78,39,17,58,64,544
Terry Rozier,SG,26,CHO,33,33,1106,245,500,0.49,111,253,0.439,134,247,0.543,0.601,75,91,0.824,18,109,127,106,46,12,68,65,676
Thaddeus Young,PF,32,CHI,30,0,760,167,274,0.609,5,22,0.227,162,252,0.643,0.619,23,46,0.5,71,105,176,131,42,17,56,81,362
Thanasis Antetokounmpo,SF,28,MIL,26,0,227,26,43,0.605,2,9,0.222,24,34,0.706,0.628,6,13,0.462,26,29,55,18,8,6,19,33,60
Théo Maledon,PG,19,OKC,31,16,797,86,218,0.394,45,127,0.354,41,91,0.451,0.498,24,32,0.75,7,85,92,102,31,2,56,69,241
Theo Pinson,SG,25,NYK,11,0,25,1,7,0.143,0,6,0,1,1,1,0.143,0,0,,0,1,1,1,0,0,0,3,2
Thomas Bryant,C,23,WAS,10,10,271,59,91,0.648,9,21,0.429,50,70,0.714,0.698,16,24,0.667,18,43,61,15,4,8,11,31,143
Thon Maker,C,23,CLE,8,0,76,10,18,0.556,0,2,0,10,16,0.625,0.556,10,11,0.909,8,10,18,4,2,4,3,7,30
Tim Frazier,PG,30,MEM,3,0,33,2,8,0.25,0,2,0,2,6,0.333,0.25,0,0,,0,4,4,7,1,0,3,4,4
Tim Hardaway Jr.,SG,28,DAL,33,17,975,190,434,0.438,97,252,0.385,93,182,0.511,0.55,65,81,0.802,12,93,105,56,20,6,30,51,542
Timothé Luwawu-Cabarrot,SF,25,BRK,34,6,669,86,221,0.389,53,146,0.363,33,75,0.44,0.509,20,26,0.769,18,62,80,43,24,5,25,63,245
Tobias Harris,PF,28,PHI,31,31,1066,241,470,0.513,51,127,0.402,190,343,0.554,0.567,94,106,0.887,37,199,236,104,25,26,58,64,627
Tomáš Satoranský,SG,29,CHI,23,0,476,60,112,0.536,19,39,0.487,41,73,0.562,0.621,26,29,0.897,8,52,60,102,12,4,34,27,165
Tony Bradley,C,23,PHI,12,1,127,22,39,0.564,0,1,0,22,38,0.579,0.564,3,5,0.6,21,29,50,6,3,7,1,11,47
Tony Snell,SG,29,ATL,23,6,420,41,85,0.482,35,62,0.565,6,23,0.261,0.688,0,0,,11,36,47,27,3,7,13,31,117
Torrey Craig,SF,30,MIL,17,0,194,17,43,0.395,8,21,0.381,9,22,0.409,0.488,1,2,0.5,13,29,42,13,9,6,5,23,43
Trae Young,PG,22,ATL,34,34,1182,262,610,0.43,85,225,0.378,177,385,0.46,0.499,288,328,0.878,25,117,142,321,30,8,149,70,897
Tre Jones,PG,21,SAS,12,0,43,9,15,0.6,1,1,1,8,14,0.571,0.633,5,5,1,4,0,4,3,0,0,4,4,24
Tremont Waters,PG,23,BOS,10,1,98,10,31,0.323,6,15,0.4,4,16,0.25,0.419,7,8,0.875,2,6,8,30,6,0,13,6,33
Trent Forrest,PG,22,UTA,7,0,20,0,3,0,0,2,0,0,1,0,0,2,2,1,0,2,2,4,2,0,1,2,2
Trey Burke,PG,28,DAL,33,0,537,92,205,0.449,41,104,0.394,51,101,0.505,0.549,27,31,0.871,4,30,34,53,22,2,19,41,252
Trey Lyles,PF,25,SAS,19,7,311,42,83,0.506,14,37,0.378,28,46,0.609,0.59,12,19,0.632,8,69,77,11,5,1,3,11,110
Tristan Thompson,PF,29,BOS,34,29,774,111,209,0.531,0,3,0,111,206,0.539,0.531,48,76,0.632,105,178,283,33,12,13,31,72,270
Troy Brown Jr.,SF,21,WAS,17,0,231,26,71,0.366,11,38,0.289,15,33,0.455,0.444,7,12,0.583,8,43,51,13,2,2,12,25,70
Ty Jerome,SG,23,OKC,4,0,100,15,30,0.5,7,19,0.368,8,11,0.727,0.617,0,0,,3,8,11,13,3,0,2,14,37
Tyler Bey,SF,22,DAL,4,0,13,2,5,0.4,0,0,,2,5,0.4,0.4,2,4,0.5,2,1,3,0,0,1,0,2,6
Tyler Cook,PF,23,BRK,4,0,17,1,3,0.333,0,0,,1,3,0.333,0.333,0,0,,1,1,2,2,0,0,1,2,2
Tyler Herro,SG,21,MIA,25,14,818,151,345,0.438,50,144,0.347,101,201,0.502,0.51,44,57,0.772,11,132,143,90,15,10,61,40,396
Tyler Johnson,SG,28,BRK,18,1,250,28,72,0.389,21,51,0.412,7,21,0.333,0.535,7,7,1,4,27,31,17,6,0,5,13,84
Tyrell Terry,PG,20,DAL,11,0,56,5,16,0.313,0,7,0,5,9,0.556,0.313,1,3,0.333,0,6,6,6,5,0,2,2,11
Tyrese Haliburton,PG,20,SAC,30,2,903,153,310,0.494,71,164,0.433,82,146,0.562,0.608,20,24,0.833,29,78,107,161,42,18,46,36,397
Tyrese Maxey,SG,20,PHI,32,6,519,109,242,0.45,15,55,0.273,94,187,0.503,0.481,22,25,0.88,8,52,60,58,15,5,22,40,255
Ty-Shon Alexander,SG,22,PHO,3,0,8,0,3,0,0,1,0,0,2,0,0,0,0,,0,1,1,1,0,0,0,1,0
Tyus Jones,PG,24,MEM,32,8,691,111,251,0.442,25,85,0.294,86,166,0.518,0.492,17,20,0.85,15,66,81,146,40,4,28,14,264
Udoka Azubuike,C,21,UTA,12,0,49,4,7,0.571,0,0,,4,7,0.571,0.571,4,6,0.667,4,9,13,0,1,4,3,8,12
Vernon Carey Jr.,C,19,CHO,3,0,6,1,3,0.333,0,1,0,1,2,0.5,0.333,1,2,0.5,2,1,3,1,0,1,0,0,3
Victor Oladipo,SG,28,TOT,24,24,786,174,436,0.399,60,181,0.331,114,255,0.447,0.468,71,95,0.747,8,117,125,109,36,11,53,56,479
Victor Oladipo,SG,28,IND,9,9,300,64,152,0.421,25,69,0.362,39,83,0.47,0.503,27,37,0.73,1,50,51,38,15,2,18,23,180
Victor Oladipo,SG,28,HOU,15,15,486,110,284,0.387,35,112,0.313,75,172,0.436,0.449,44,58,0.759,7,67,74,71,21,9,35,33,299
Vincent Poirier,C,27,PHI,6,0,22,1,4,0.25,0,0,,1,4,0.25,0.25,2,4,0.5,2,2,4,1,0,2,2,2,4
Vlatko ?an?ar,PF,23,DEN,20,0,122,11,28,0.393,3,14,0.214,8,14,0.571,0.446,5,6,0.833,4,23,27,6,7,2,9,11,30
Wayne Ellington,SG,33,DET,28,24,650,103,227,0.454,77,178,0.433,26,49,0.531,0.623,20,27,0.741,8,39,47,40,13,6,19,43,303
Wendell Carter Jr.,C,21,CHI,23,23,618,106,198,0.535,7,20,0.35,99,178,0.556,0.553,63,86,0.733,48,131,179,52,16,19,43,74,282
Wenyen Gabriel,PF,23,NOP,4,0,12,0,3,0,0,1,0,0,2,0,0,0,0,,1,4,5,1,0,0,0,0,0
Wesley Iwundu,SF,26,DAL,20,3,246,14,47,0.298,3,23,0.13,11,24,0.458,0.33,9,11,0.818,5,30,35,8,7,3,5,20,40
Wesley Matthews,SG,34,LAL,30,4,605,42,118,0.356,31,92,0.337,11,26,0.423,0.487,12,15,0.8,12,32,44,34,15,11,15,43,127
Will Barton,SF,30,DEN,33,29,986,148,335,0.442,50,129,0.388,98,206,0.476,0.516,37,49,0.755,19,116,135,102,25,14,55,54,383
Willie Cauley-Stein,C,27,DAL,31,10,537,70,112,0.625,1,6,0.167,69,106,0.651,0.629,31,48,0.646,39,101,140,24,10,23,16,73,172
Willy Hernangómez,C,26,NOP,20,2,359,60,110,0.545,1,5,0.2,59,105,0.562,0.55,24,36,0.667,53,86,139,26,7,10,11,27,145
Xavier Tillman Sr.,PF,22,MEM,27,7,551,81,158,0.513,10,35,0.286,71,123,0.577,0.544,17,23,0.739,40,85,125,45,25,16,24,64,189
Yogi Ferrell,PG,27,CLE,2,0,40,8,21,0.381,3,9,0.333,5,12,0.417,0.452,0,2,0,3,4,7,5,3,1,3,4,19
Yuta Watanabe,SF,26,TOR,22,1,268,20,60,0.333,12,33,0.364,8,27,0.296,0.433,8,8,1,18,53,71,8,9,12,8,23,60
Zach LaVine,SG,25,CHI,34,34,1209,350,667,0.525,120,276,0.435,230,391,0.588,0.615,156,182,0.857,25,152,177,173,37,14,133,90,976
Zeke Nnaji,PF,20,DEN,23,1,248,31,61,0.508,15,36,0.417,16,25,0.64,0.631,5,7,0.714,10,23,33,3,3,2,5,16,82
Zion Williamson,PF,20,NOP,34,34,1126,335,546,0.614,6,19,0.316,329,527,0.624,0.619,194,279,0.695,93,152,245,117,32,24,88,82,870
